11
1
######
#F # #
## #v#
#  # #
##   #
######